0 0 0 0 0 0 0 0 0 0   0 0 0 0 0 0 0 0 0 0   0 0 0 0 0 0 0 0 0 0   0 0 0 0 0 0 0 0 0 0   0 0 0 0 0 0 0 0 0 0   0 0 0 0 0 0 0 0 0 0   0 0 0 0 0 0 0 0 0 0   0 0 0 0 0 0 0 0 0 0   0 0 0 0 0 0 0 0 0 0   0 0 0 0 0 0 0 0 0 0   0 0 0 0 0 0 0 0 0 0   0 0 0 0 0 0 6 0 0 0
0 0 0 0 0 0 0 0 0 0   0 0 0 0 0 0 0 0 0 0   0 0 0 0 0 0 0 0 0 0   0 0 0 0 0 0 0 0 0 0   0 0 0 0 0 0 0 0 0 0   0 0 0 0 0 0 0 0 0 0   0 0 0 0 0 0 0 0 0 0   0 0 0 0 0 0 0 0 0 0   0 0 0 0 0 0 0 0 0 0   0 0 0 0 0 0 0 0 0 0   0 0 0 0 0 0 0 0 0 0   0 0 0 0 0 0 6 0 0 0
0 0 0 0 0 0 0 0 0 0   0 0 0 0 0 0 0 0 0 0   0 0 0 0 0 0 0 0 0 0   0 0 0 0 0 0 0 0 0 0   0 0 0 0 0 0 0 0 0 0   0 0 0 0 0 0 0 0 0 0   0 0 0 0 0 0 0 0 0 0   0 0 0 0 0 0 0 0 0 0   0 0 0 0 0 0 0 0 0 0   0 0 0 0 0 0 0 0 0 0   0 0 0 0 0 0 0 0 0 0   0 0 0 0 0 0 6 0 0 0
0 0 0 0 0 0 0 0 0 0   0 0 0 0 0 0 0 0 0 0   0 0 0 0 0 0 0 0 0 0   0 0 0 0 0 0 0 0 0 0   0 0 0 0 0 0 0 0 0 0   0 0 0 0 0 0 0 0 0 0   0 0 0 0 0 0 0 0 0 0   0 0 0 0 0 0 0 0 0 0   0 0 0 0 0 0 0 0 0 0   0 0 0 0 0 0 0 0 0 0   0 0 0 0 0 0 0 0 0 0   0 0 0 0 0 0 6 0 0 0
0 0 0 0 0 0 0 0 0 0   0 0 0 0 0 0 0 0 0 0   0 0 0 0 0 0 0 0 0 0   1 1 0 0 0 0 1 1 1 1   0 0 0 0 1 0 1 0 0 0   0 0 0 0 1 1 0 0 0 0   0 0 0 0 0 0 0 0 0 0   0 0 0 0 0 0 0 0 0 0   0 0 0 0 0 0 0 0 0 0   0 0 0 0 0 0 0 0 0 0   0 0 0 0 0 0 0 0 0 0   0 0 0 0 0 0 6 0 0 0
0 0 0 0 0 0 0 0 0 0   0 0 0 3 0 0 0 0 0 0   0 0 0 0 3 0 0 0 0 0   0 0 0 0 0 1 2 0 0 0   0 0 0 0 0 0 0 0 0 0   0 0 0 1 2 2 1 0 0 0   0 0 0 0 0 3 0 0 0 0   0 0 0 0 0 0 0 0 0 0   0 0 0 0 0 0 0 0 0 0   0 0 0 0 0 0 0 0 0 0   0 0 0 0 0 0 0 0 0 0   0 0 0 0 0 0 6 0 0 0
0 0 0 0 0 0 0 0 0 0   0 0 0 0 0 0 0 0 0 0   0 0 0 0 0 0 0 0 0 0   0 0 0 1 0 0 0 3 0 0   0 0 1 1 1 3 1 1 0 0   0 0 1 2 2 2 2 3 0 0   0 0 0 0 0 0 0 0 1 1   0 0 0 0 0 0 0 0 0 0   0 0 1 0 8 0 1 1 0 0   0 0 0 0 0 0 0 0 0 0   0 0 0 0 0 0 0 0 0 0   0 0 0 0 0 0 6 0 0 7
1 1 1 1 1 1 1 1 1 1   1 1 1 1 1 1 1 1 1 1   1 1 1 8 1 8 1 8 1 1   1 1 1 2 0 0 0 0 0 1   1 1 2 2 2 1 2 2 1 0   0 1 2 2 2 2 2 1 1 0   0 0 8 0 1 1 0 0 2 2   1 8 1 3 1 8 1 8 1 1   0 1 2 1 0 1 2 2 1 1   1 0 3 0 3 0 3 0 3 1   5 5 5 5 5 5 5 5 5 5   5 5 5 5 5 5 5 5 5 5
2 2 2 2 2 2 2 2 2 2   2 2 2 2 2 2 2 2 2 2   2 2 2 2 2 2 2 2 2 2   2 2 2 2 1 1 1 1 1 2   2 2 2 2 2 2 2 2 2 1   1 2 2 2 2 2 2 2 2 1   1 1 1 1 2 2 1 1 2 2   2 1 2 1 2 1 2 1 2 2   1 2 2 2 1 2 2 2 2 2   2 1 1 1 1 1 1 1 1 2   4 4 4 4 4 4 4 4 4 4   4 4 4 4 4 4 4 4 4 4
2 2 2 2 2 2 2 2 2 2   2 2 2 2 2 2 2 2 2 2   2 2 2 2 2 2 2 2 2 2   2 2 2 2 2 2 2 2 2 2   2 2 2 2 2 2 2 2 2 2   2 2 2 2 2 2 2 2 2 2   2 2 2 2 2 2 2 2 2 2   2 2 2 2 2 2 2 2 2 2   2 2 2 2 2 2 2 2 2 2   2 2 2 2 2 2 2 2 2 2   4 4 4 4 4 4 4 4 4 4   4 4 4 4 4 4 4 4 4 4
